111111111111111
11E0000101P0001
111110010111111
111010011111111
11CCCCCCCCCCCC1
111111111111111
111111111111111
