111111111111111
11000001C1000P1
111110010111111
1111C0011111111
11E00000C0000C1
111111111111111
111111111111111