1111111111111111
11P0000001E00001
11111001001C0001
1110101110111001
1100001011000001
1011100000010101
1111111111111111
