1111111111111111
11E0000001PC0001
111110010C1C0001
111010111C111C01
11CCCC1C11CCCC01
1111100C00010101
1111111111111111
